111111111111111111111111111111111111111111111111111111111111111111111111111111111111111111111111111111111
1.......................................................................................................1
1.......................................................................................................1
1..........22222222222222222222222222...................................................................1
1..........2........................2...................................................................1
1..........2........................2...................................................................1
1..........2..........P.............2...................................................................1
1..........2........................2...................................................................1
1..........2........................2...................................................................1
1..........2........................2...................................................................1
1..........2........................2...................................................................1
1..........2222222222......2222222222...................................................................1
1.......................................................................................................1
1.......................................................................................................1
1.......................................................................................................1
1.........................................111111111111111111111111111111111111111.......................1
1.........................................1.....................................1.......................1
1.........................................1.....................................1.......................1
1.........................................1.....................................1.......................1
1.........................................1.....................................1.......................1
1.........................................1.....................................1.......................1
1.........................................1.....................................1.......................1
1.........................................1.....................................1.......................1
1.......................................................................................................1
1.......................................................................................................1
1.......................................................................................................1
1.........................................1.....................................1.......................1
1.........................................1.....................................1.......................1
1.........................................1.....................................1.......................1
1.........................................1.....................................1.......................1
1.........................................1.....................................1.......................1
1.........................................1.....................................1.......................1
1.........................................111111111111111111111111111111111111111.......................1
1.......................................................................................................1
1.......................................................................................................1
1.......................................................................................................1
1.......................................................................................................1
1.......................................................................................................1
1.......................................................................................................1
1.......................................................................................................1
1.......................................................................................................1
1.......................................................................................................1
1.......................................................................................................1
1.......................................................................................................1
1.......................................................................................................1
1.......................................................................................................1
1.......................................................................................................1
1.......................................................................................................1
1.......................................................................................................1
111111111111111111111111111111111111111111111111111111111111111111111111111111111111111111111111111111111